######################
#     #      #       # 
#     #      #       #
#     +      ####+####
#     #     @#       #
#     ###+####       #
#     #      #       #
#     #      +       #
#     #      #       #
###+#############+####
#                    #
#                    #
######################