##############
#     #      #
#     #      #
#     +      #
#     #      #
#     ###+####
#     #      #
#     +      #
#     #      #
##############