################################
#     #      #       ########### 
#     # #    #       ###########
#     +  #   ####+##############
#  #  #     @#       ###########
#     ###+####       ###########
#     #      #       ###########
#     #      +       ###########
#     #      #       ###########
###+#############+##############
#                    ###########
#                    ###########
################################