################################
#     #      #                 # 
#     # #    #       ###########
#     +  #   ####+##############
#  #  #     @#                 #
#     ###+####              ####
#     #      #                 #
#     #      +                ##
#     #      #                ##
###+#############+##############
#                         # ## #
#                              #
#                              #
#                              #
#                              #
#                              #
#                              #
#                              #
################################