#######
#     #
###   #
##  ###
#######