########################################
#     #      #                 +       #
#     # #    #       ###########       #
#     +  #   ####+##############       #
#  #  #     @#       #         #       #
#     ###+####       #      ####       #
#     #      #       #         #       #
#     #      +       #        ##       #
#     #      #       #        ##       #
###+#############+#####+############+###
#                    #    #### #       #
#    ### #          ##    #    #       #
#      ###         ##     #    # #######
#                 ##      #    #       #
#         ####+####       #    ####    #
#        ##               #    +  #    #
#       ##                #    ####    #
#      ##    #######      #    #       #
#     ##       #######    #    ####    #
#    ##         #######   #    +  #    #
#   ##         ####       #    #  #    #
#  ##           ##        ##+# #  #    #
# ##                           #       #
###                 ####       #       #
########################################