######################
#     #      #       # 
#     # #    #       #
#     +  #   ####+####
#  #  #     @#       #
#     ###+####       #
#     #      #       #
#     #      +       #
#     #      #       #
###+#############+####
#                    #
#                    #
######################